Kris Abrams-Draine	CB	Missouri
Daijahn Anthony	S	Ole Miss
Terrion Arnold	CB	Alabama
Cole Bishop	S	Utah
Beau Brade	S	Maryland
Millard Bradford	S	TCU
Jarvis Brownlee Jr.	CB	Louisville
Javon Bullard	S	Georgia
Calen Bullock	S	USC
Jaylon Carlies	S	Missouri
Caelen Carson	CB	Wake Forest
Ryan Cooper Jr.	CB	Oregon State
Cooper DeJean	CB	Iowa
M.J. Devonshire	CB	Pittsburgh
Marcellas Dial	S	South Carolina
Johnny Dixon	CB	Penn State
Willie Drew	CB	Virginia State
Renardo Green	CB	Florida State
Kamal Hadden	CB	Tennessee
Dominique Hampton	S	Washington
Myles Harden	CB	South Dakota
Daequan Hardy	CB	Penn State
Cam Hart	CB	Notre Dame
Jaden Hicks	S	Washington State
Khyree Jackson	CB	Oregon
DJ James	CB	Auburn
Carlton Johnson	CB	Fresno State
Isaiah Johnson	S	Syracuse
Elijah Jones	CB	Boston College
Jarrian Jones	CB	Florida State
Jaylen Key	S	Alabama
Kamren Kinchens	S	Miami
Kalen King	CB	Penn State
Kamari Lassiter	CB	Georgia
Dwight McGlothern	CB	Arkansas
Kool-Aid McKinstry	CB	Alabama
Patrick McMorris	S	California
Max Melton	CB	Rutgers
Quinyon Mitchell	CB	Toledo
Malik Mustapha	S	Wake Forest
Josh Newton	CB	TCU
Tyler Nubin	S	Minnesota
Kitan Oladapo	S	Oregon State
Tyler Owens	S	Texas Tech
Andru Phillips	CB	Kentucky
Deantre Prince	CB	Ole Miss
Nehemiah Pritchett	CB	Auburn
Josh Proctor	S	Ohio State
Ennis Rakestraw Jr.	CB	Missouri
Decamerion Richardson	CB	Mississippi State
Demani Richardson	S	Texas A&M
Christian Roland-Wallace	CB	USC
Mike Sainristil	CB	Michigan
Andre' Sam	S	LSU
Jaylin Simpson	CB	Auburn
Tykee Smith	S	Georgia
Chau Smith-Wade	CB	Washington State
Tarheeb Still	CB	Maryland
T.J. Tampa	CB	Iowa State
Dadrion Taylor-Demerson	S	Texas Tech
Ro Torrence	CB	Arizona State
Sione Vaki	S	Utah
Josh Wallace	CB	Michigan
Ryan Watts	CB	Texas
Nate Wiggins	CB	Clemson
Evan Williams	S	Oregon
James Williams	S	Miami